####################
#                  #
#                  #
#                  #
#                  #
#                  #
#################  #
#               #  #
#               #  #
#       #       #  #
#       #   V   #  #
#       #       #  #
#       #########  #
#                  #
#                  #
#                  #
#    #########     #
#               T  #
#                  #
####################
