####################
#                  #
#                  #
#    ###############
#                  #
#                  #
#############      #
#           #      #
#           #      #
#    #      #      #
#    #      #      #
#    #   V  #      #
#    ########      #
#                  #
#                  #
#                  #
#    #########     #
#               T  #
#                  #
####################
