########################################
#                                      #
#                                      #
#      #################################
#                                      #
#                                      #
#############      #####################
#           #      #T                  #
#           #      #                   #
#    #      #      ##############      #
#    #      #      #            #      #
#    #     V#      #            #      #
#    ########      #     #             #
#                  #     #             #
#                  #     ###############
#                  #                   #
#    ###############                   #
#                        #######       #
#                              #       #
########################################
