####################
#                  #
#                  #
#                  #
#                  #
#                  #
#                  #
#                  #
#                  #
#                  #
#                  #
#                  #
#    V             #
#                  #
#                  #
#                  #
#                  #
#                  #
#                  #
####################
