####################
#                  #
#                  #
#     T            #
#                  #
#                  #
#                  #
#                  #
#          T       #
#                  #
#                  #
#                  #
#    V             #
#                  #
#                  #
#                  #
#      T           #
#                  #
#                  #
####################
