####################
#                  #
#                  #
#    ###############
#                  #
#                  #
#############      #
#    #             #
#    #             #
#    #      #      #
#    #      #      #
#    #      #      #
#    ########      #
#                  #
#                  #
#                  #
#    #########     #
#                  #
#                  #
####################
