####################
#    ##########    #
#    ##########    #
#        #         #
#                  #
#                  #
#                  #
#                  #
#############      #
#    #             #
#    #             #
#    #             #
#    #      #      #
#    #      #      #
#    #      #      #
#    ########      #
#                  #
#                  #
#                  #
####################
