########################################
#                                      #
#                                      #
#      #################################
#                                      #
#                                      #
#############      #####################
#           #      #T                  #
#           #      #                   #
#    #      #      ##############      #
#    #      #      #            #      #
#    #     V#      #            #      #
#    ########      #     #             #
#                  #     #             #
#                  #     ###############
#                  #                   #
#    ###############                   #
#                        #######       #
#                              #       #
#                              #       #
#    ###########################       #
#    #                                 #
#    #                                 #
#    ############          #############
#                          #           #
#                          #           #
#                          #           #
#                                      #
#                                      #
#                                      #
#                                      #
#                                      #
#                                      #
#                                      #
#                                      #
#                                      #
#                                      #
#                                      #
#                                      #
########################################